55555555555555555555555
50000000000000000000005
50545000005000000050005
50505055504000000505005
50525050405000005000505
50500050505000005525505
50500005005555050000055
50000000000000000000005
55000000000000545000005
55500000000000525000005
55550000000000505000005
55555000000555545000005
50005000000400005000005
50000500000555505000005
50000200000000545000005
50005000000000505000005
53005000000000505000005
55550000555555545000005
55500000000000005000005
55000000555555505000005
50000000000000505000005
55000000000000505000005
55550000000000205000005
55555555555555555555555
