55555555555555555555555
50000505000000005000005
50000405050000004000005
50000500050000005000005
55555555555555555555505
50000000000000000000005
50555555554555555555555
50500000000000040000005
55505555555555505555555
50005000000000505000005
55555005005000505050505
50000005005000505050005
50000000000000505050505
50000000000000505050005
50000000000000500050505
50000000000000555550005
50555000555550000050505
53005000500005000050005
55525555505505000050505
55000555500505545050505
50050000000500000050505
54555555555555555550005
50040040040040040040555
55555555555555555555555