55555555555555555555555
55555000000000000055555
55500000005000000000555
55000000000000000000055
55000000005000000000055
50000000000000000000005
55500000005000000444445
50000000000000000000005
54444400005000055555555
50000000005000000000005
55550000000000000444445
50000000005000000000005
50505050504050505050505
50000000005000000000005
54445544500000000454545
50000000005000000000005
55454000000000000454545
50000000005000000000005
54445540000000044555445
55000000005000000000055
55000000000000000000055
55500000005000000000555
55555000000000000055555
55555555555555555555555